⌠▓▓⌠▓▓▓⌠▓▓▓▓▓▓▓▓▓▓▓▓▓▓▓▓▓▓▓▓▓▓▓▓▓▓▓▓▓▓▓▓▓▓▓▓⌠⌠⌠⌠⌠⌠⌠⌠⌠⌠⌠⌠⌠⌠⌠⌠⌠⌠⌠⌠⌠⌠⌠⌠⌠▓▓▓▓▓▓▓▓▓▓▓▓▓▓▓▓⌠⌠⌠⌠⌠⌠⌠⌠⌠
▓▓⌠▓⌠▓⌠▓▓▓▓▓▓▓▓▓▓▓▓▓▓▓▓▓▓▓▓▓▓▓▓▓▓▓▓▓▓▓▓▓▓▓▓▓▓▓▓▓▓⌠⌠⌠⌠▓▓▓⌠▓▓⌠⌠⌠⌠▓⌠⌠▓▓▓▓▓▓▓▓▓▓▓▓▓▓▓▓▓▓▓▓▓⌠⌠⌠⌠⌠⌠⌠
▓⌠▓▓⌠⌠▓▓⌠▓▓▓▓▓▓▓▓▓▓▓▓▓▓▓▓▓▓▓▓▓▓▓▓▓▓▓▓▓▓▓▓⌠▓▓▓▓▓▓▓⌠⌠⌠⌠▓▓▓▓▓▓⌠⌠⌠⌠⌠⌠⌠▓▓▓▓▓▓▓▓▓▓▓▓▓▓▓▓▓▓▓▓▓▓⌠⌠⌠⌠⌠⌠
▓▓⌠⌠▓▓▓▓▓▓▓▓▓▓▓▓▓▓▓▓▓▓▓▓▓▓▓▓▓▓▓▓▓▓▓▓▓▓▓▓▓⌠⌠⌠▓▓▓▓▓⌠▓⌠⌠▓▓▓▓▓▓▓⌠⌠⌠⌠⌠▓▓▓▓▓▓▓▓▓▓▓▓▓▓▓▓▓▓▓▓▓▓▓⌠⌠⌠⌠⌠⌠
▓▓⌠▓▓⌠▓▓▓▓▓▓▓▓▓▓▓▓▓▓▓▓▓▓▓▓▓▓▓▓▓▓▓▓▓▓▓▓▓▓⌠⌠⌠▓▓▓▓▓⌠⌠⌠⌠⌠⌠⌠▓▓▓▓▓▓⌠⌠⌠▓▓▓▓▓▓▓▓▓▓▓▓▓▓▓▓▓▓▓▓▓▓▓▓▓▓▓⌠⌠⌠
⌠▓⌠▓⌠▓▓▓▓▓▓▓▓▓▓▓▓▓▓▓▓▓▓▓▓▓▓▓▓▓▓▓▓▓▓▓▓▓▓▓▓⌠⌠▓▓▓▓▓⌠⌠⌠⌠⌠⌠⌠▓▓▓▓▓⌠⌠⌠⌠▓▓▓▓▓▓▓▓▓▓▓▓▓▓▓▓▓▓▓▓▓▓▓▓▓▓⌠⌠⌠⌠
▓⌠▓▓⌠▓▓▓▓▓▓▓▓▓▓▓▓▓▓▓▓▓▓▓▓▓▓▓▓▓▓▓▓▓▓▓▓▓▓▓⌠⌠⌠▓▓▓▓▓⌠⌠⌠⌠⌠⌠⌠⌠⌠▓▓▓▓▓▓▓▓▓▓▓▓▓▓▓▓▓▓▓▓▓▓▓▓▓▓▓▓▓▓▓▓▓▓▓▓░
▓⌠▓▓▓▓▓▓▓▓▓▓▓▓▓▓▓▓▓▓▓▓▓⌠⌠⌠⌠▓▓▓▓▓▓▓▓▓▓▓▓▓▓▓▓▓▓▓▓▓▓▓⌠⌠⌠⌠▓⌠⌠▓▓▓▓▓▓▓▓▓▓▓▓▓▓▓▓▓▓▓▓▓▓▓▓▓▓▓▓▓▓▓▓▓▓▓░▒
▓▓▓▓▓▓▓▓▓▓▓▓▓▓▓▓▓▓▓▓▓▓⌠⌠⌠░░░▓▓▓▓▓▓▓▓▓▓▓▓▓▓▓▓▓▓▓▓▓▓▓⌠⌠⌠⌠⌠▓▓▓▓▓▓▓▓▓▓▓▓▓▓▓▓▓▓▓▓▓▓▓▓▓▓▓▓▓▓▓▓▓▓▓▓▒▒
⌠▓▓▓▓▓▓▓▓▓▓▓▓▓▓▓▓▓▓▓▓⌠⌠⌠░░░░░▓▓▓▓▓▓▓▓▓▓▓▓▓▓▓▓▓▓▓▓▓▓⌠⌠⌠▓▓▓▓▓▓▓▓▓▓▓▓▓▓▓▓▓▓▓▓▓▓▓▓▓▓▓▓▓▓▓▓▓▓▓▓░░▒░
▓▓▓▓▓▓▓▓▓▓▓▓▓▓▓▓▓▓▓▓⌠⌠⌠░░░░░░░▓▓▓▓▓▓▓▓▓▓▓▓▓▓▓▓▓▓▓▓▓⌠⌠▓▓▓▓▓▓▓▓▓▓▓▓▓▓▓▓▓▓▓▓▓▓▓▓▓▓▓▓▓▓▓▓▓▓▓▓░▒▒▒▒
▓▓▓▓▓▓▓▓▓▓▓▓▓▓▓▓▓▓▓▓▓⌠░░░░░░░░░▓▓▓▓▓▓▓▓▓▓▓▓▓▓▓▓▓▓▓▓▓⌠▓▓▓▓▓▓▓▓▓▓⌠▓▓▓▓▓▓▓▓▓▓▓▓▓▓▓▓▓▓▓▓▓▓▓▓░▒▒▒▒▒
▓▓▓▓▓▓▓▓▓▓▓▓▓▓▓▓▓▓▓▓▓░░░░░░░░░░░▓▓▓▓▓▓▓▓▓▓▓▓▓▓▓▓▓▓▓▓▓▓▓▓▓▓▓▓▓▓⌠⌠▓▓▓▓▓▓▓▓▓▓▓▓▓▓▓▓▓▓▓▓▓▓▓▓░▒▒▒▒▒
▓▓▓▓▓▓▓▓▓▓▓▓▓▓▓▓▓▓▓▓░░░░░░░░░░░▓▓▓▓▓▓▓▓▓▓▓▓▓▓▓▓▓▓▓▓▓▓▓▓▓▓▓▓▓▓▓⌠⌠⌠▓▓▓▓▓▓▓▓▓▓▓▓▓▓▓▓▓▓▓▓▓▓░▒▒▒▒▒▒
▓▓▓▓▓▓▓▓▓▓▓▓▓▓▓▓▓▓▓▓▓░░░░░░░░░▓▓▓▓▓▓▓▓▓▓▓▓▓▓▓▓▓▓▓▓▓▓▓▓▓▓▓▓▓▓▓▓▓⌠▓▓▓▓▓▓▓▓▓▓▓▓▓▓▓▓▓▓▓▓▓▓⌠▒▒▒▒░▒▒
▓▓▓▓▓▓▓▓▓▓▓▓▓▓▓▓▓▓▓▓▓▓▓░░░░░░▓▓▓▓▓▓▓▓▓▓▓▓▓▓▓▓▓▓▓▓▓▓▓▓▓▓▓▓▓▓▓▓▓▓▓▓▓▓▓▓▓▓▓▓▓▓▓▓▓▓▓▓▓▓⌠⌠⌠░▒▒▒▒▒▒▒
▓▓▓▓▓▓▓▓▓▓▓▓▓▓▓▓▓▓▓▓▓▓▓⌠⌠░░░▓▓▓▓▓▓▓▓▓▓▓▓▓▓▓▓▓▓▓▓▓▓▓▓▓▓▓▓▓▓▓▓▓▓▓▓▓▓▓▓▓▓▓▓▓▓▓▓▓▓▓▓░░░░░░▒▒▒▒▒▒▒░
▓▓▓▓▓▓▓▓░░⌠▓▓▓▓▓▓▓▓▓▓▓▓▓▓⌠▓▓▓▓▓▓▓▓▓▓▓▓▓▓▓▓▓▓▓▓▓▓▓▓▓▓▓▓▓▓▓▓▓▓▓▓▓▓▓▓▓▓▓▓▓⌠▓▓▓▓▓▓▓░▒▒▒▒▒▒▒▒▒▒▒▒░░
▓▓▓▓▓▓⌠░░░░▓▓▓▓▓▓▓▓▓▓▓▓▓▓▓▓▓▓▓▓▓▓▓▓▓▓▓▓▓▓▓▓▓▓▓▓▓▓▓▓▓▓▓▓▓▓▓▓▓▓▓▓▓▓▓▓▓▓▓⌠⌠⌠▓▓▓▓▓░▒▒▒▒▒▒▒▒▒▒▒▒▒░▒
▓▓▓▓▓⌠░░░░░░▓▓▓▓▓▓▓▓▓▓▓▓▓▓▓▓▓▓▓▓▓▓▓▓▓▓▓▓▓▓▓▓▓▓▓▓▓▓▓▓▓▓▓▓▓▓▓▓▓▓▓▓▓▓▓▓▓⌠⌠⌠⌠⌠▓▓▓⌠▒▒▒▒▒▒▒▒░▒▒▒▒░▒░
▓▓▓▓⌠░░░░░░⌠▓▓▓▓▓▓▓▓▓▓▓▓▓▓▓▓▓▓▓▓▓▓▓▓▓▓▓▓▓▓▓▓▓▓▓▓▓▓▓▓▓▓▓▓▓▓▓▓▓▓▓⌠▓▓▓▓⌠⌠⌠⌠⌠⌠▓▓▓░▒▒▒░▒▒▒▒▒▒▒▒░▒░▒
▓▓▓▓▓⌠⌠░░░⌠▓▓▓▓▓▓▓▓▓▓▓▓▓▓▓▓▓▓▓▓▓▓▓▓▓▓▓▓▓▓▓▓▓▓▓▓▓▓▓▓▓▓▓▓▓▓▓▓▓▓▓⌠⌠⌠▓▓⌠⌠⌠⌠⌠⌠⌠⌠▓░▒▒▒▒▒▒▒▒▒▒▒▒▒▒░▓▓
▓▓▓▓▓▓▓⌠▓░▓▓▓▓▓▓▓▓▓▓▓▓▓▓▓▓▓▓▓▓▓▓▓▓▓▓▓▓▓▓▓▓▓▓▓▓▓▓▓▓▓▓▓▓▓▓▓▓▓▓⌠⌠⌠⌠⌠⌠⌠⌠⌠⌠⌠⌠⌠⌠⌠░▒▒▒▒▒▒▒▒▒▒░▒▒▒░▓▓▓